BACKWARD	B AE K W ER D
BALL	B AO L
COME	K AH M
DOWN	D AW N
FETCH	F EH CH
FIND	F AY N D
FOLLOW	F AA L OW
FORWARD	F AO R W ER D
GET	G EH T
GET(2)	G IH T
GO	G OW
LAY	L EY
LEFT	L EH F T
PET	P EH T
RIGHT	R AY T
ROAM	R OW M
ROTATE	R OW T EY T
SING	S IH NG
SPEAK	S P IY K
SPIN	S P IH N
STAY	S T EY
STOP	S T AA P
TURTLE	T ER T AH L
WANDER	W AA N D ER
